.........................
#....###############....#
.....#p..........cc#.....
.....#.#####.#####.#.....
.....#.............#.....
.....#.#####.#####.#.....
.....#cc........ccb#.....
.....#######.#######.....
.....#............b#.....
.....#.#####.#####.#.....
.....#............b#.....
.....#.#####.#####.#.....
.....#............b#.....
.....###############.....
.........................