.........................
.....###############.....
.....#p............#.....
.....#.#####.#####.#.....
.....#.............#.....
.....#.#####.#####.#.....
.....#cc..........b#.....
.....#######.#######.....
.....#............b#.....
.....#.#####.#####.#.....
.....#............b#.....
.....#.#####.#####.#.....
.....#............b#.....
.....###############.....
.........................