.........................
.....###############.....
.....#p...........k#.....
.....#.#####.#####.#.....
.....#.............#.....
.....#.#####.#####.#.....
.....#cc....vs....b#.....
.....#######.#######.....
.....#............b#.....
.....#.#####.#####.#.....
.....#............b#.....
.....#.#####.#####.#.....
.....#............b#.....
.....###############.....
.........................